....................
....................
.......C..X.........
.......######.......
B.G..............G.B
####..G.G.G.G....###
.......G.G.GCG......
......--------......
....-...........-...
....................
BG.G............G.GB
####............####
....................
.1..................
####################
